able	할 수 있는
absent	결석한
abuse	남용하다, 학대하다
accept	받아들이다
accident	사고, 뜻밖의 사건
ache	아프다
activity	활동
actually	실제로
add	더하다
address	주소, 연설
admiral	해군대장
adult	성인
adventure	모험
advice	충고
affair	사건, 일
afraid	무서워하여
afterward	후에, 나중에
agree	동의하다
ahead	앞으로, 앞에
airport	공항
alarm	놀라게하다, 경보하다
alive	살아있는
allow	허락하다
almost	거의
alone	홀로, 혼자서
along	~을 따라서
altogether	아주, 전부
amateur	아마추어
amazing	놀라운
amount	양, 총계
amuse	재미있게 하다
ancestor	조상
ancient	고대의
angle	각도
angry	화난
answer	대답, 대답하다
anxious	걱정하는, 열망하는
anyway	어쨌든
apart	떨어져서, 따로
appear	나타나다, ~으로 보이다
appetite	식욕
appointment	약속, 지정, 임명
area	지역
army	군대
arrest	체포하다
arrive	도착하다
art	예술, 미술
astonish	놀라게하다
athlete	운동선수
atom	원자
attend	참석하다, 돌보다
attract	마음을 끌다
background	배경
badly	나쁘게, 몹시
balance	균형
bar	막대기
base	기초, 기초를 두다
basement	지하실
bathroom	욕실
battle	전투, 싸움
bay	만
beach	해안
bean	콩
bear	낳다, 참다
beast	짐승
beat	때리다
beauty	아름다움
become	~이 되다, 어울리다
bedside	침대곁
beef	쇠고기
beer	맥주
beg	구걸하다, 청하다
beggar	거지
behave	행동하다
behind	~의 뒤에
believe	믿다
belong	~에 속하다
below	~의 아래에
belt	띠, 허리띠
bend	구부리다
besides	게다가
bet	내기걸다, 단언하다
beyond	~을 지나서, 초월하여
bike	자전거
bill	계산서, 지폐, 법안
biology	생물학
birth	출생
bit	작은 조각, 조금
bite	물다, 물어뜯다
blanket	담요
bless	축복하다
blind	눈먼
blood	피
blow	불다
board	판자, 탑승
body	몸, 신체
bone	뼈
bookstore	서점
booth	오두막집, 작은 방
boring	지겨운
borrow	빌리다
bother	괴롭히다
bottle	병
bottom	밑, 밑바닥
bow	절하다, 활
bowl	사발, 그릇
brain	뇌
branch	나뭇가지, 지점
break	부수다, 깨뜨리다
breathe	숨쉬다, 호흡하다
bridge	다리
bright	밝은, 영리한
bring	가져오다
british	영국인, 영국의
brown	갈색
bubble	거품
build	짓다, 건축하다
burden	짐, 부담
burn	타다, 태우다
bury	파묻다
bush	수풀, 덤불
business	사업, 일
busy	바쁜
butterfly	나비
cage	새장, 우리
calm	고요한
canal	운하
candle	양초, 촛불
capital	수도, 자본
captain	우두머리, 선장
care	걱정
carry	나르다, 운반하다
carve	새기다, 조각하다
cash	현금, 현금으로 바꾸다
castle	성
cause	원인, 이유
ceiling	천장
celebrate	축하하다
cemetery	묘지
center	중심지
century	세기, 100년
ceremony	의식
certain	확실한, 어떤
chain	사슬
chance	기회, 가능성
change	변화, 잔돈
charge	짐을 싣다, 청구하다, 책임
charming	매력적인
chase	쫓다, 추적
cheap	값싼
check	방해하다, 대조하다, 수표
cheek	볼, 빰
chest	가슴, 상자
chief	우두머리, 주요한
choose	고르다, 선택하다
chopstick	젓가락
circle	원
clap	탁 치다, 손뼉치다
clean	깨끗한
clear	맑은, 명백한, 깨끗이치우다
cleave	쪼개다
clerk	사무원, 점원
clever	영리한
climate	기후
climb	오르다
close	닫다, 가까운
closet	벽장
cloth	천, 직물
cloudy	구름이 낀
clue	실마리, 단서
coal	석탄
coast	해안
coeducation	남녀공학
coil	코일, 감긴 것
coin	동전
collect	모으다, 수집하다
college	단과대학, 전문대학
colorful	화려한
comb	빗, 빗질하다
comedy	희극, 코미디
comfort	안락, 위안
common	공통의, 보통의
communication	통신, 의사소통
company	친구, 회사
comparison	비교
competent	유능한
competition	경쟁
complain	불평하다
complete	완성하다
composer	작곡가
compulsory	의무적인
concert	음악회
contest	경쟁
continent	대륙
continue	계속하다
contrary	반대의
control	통제하다, 지배하다
cool	서늘한, 근사한
corn	곡물, 옥수수
correctly	바르게, 정확히
cost	비용
cotton	솜, 면
cough	기침, 기침을 하다
count	세다, 계산하다
couple	한쌍, 커플
course	진로, 과정
cousin	사촌
cover	덮개, 덮다
crack	갈라진 틈
crash	충돌[추락]
crazy	미친
create	창조하다
creek	시냇물
crew	승무원
cricket	크리켓 경기
crop	농작물
crowded	붐비는, 혼잡한
crown	왕관
culture	문화,교양
curious	호기심이 강한
custom	관습
damage	손해, 손상
danger	위험
dark	어두운
data	자료
date	날짜
daughter	딸
dawn	새벽
deal	다루다, 분배하다
dear	친애하는, 값비싼
death	죽음
debt	빚
decide	결심하다, 결정하다
deck	갑판
declare	선언하다
decrease	감소하다
deep	깊은, 깊게
deer	사슴
degree	정도, 도, 학위
delicious	맛있는
delight	기쁨
democracy	민주주의
department	부문, 부서
depend	~에 의존하다
describe	묘사하다
desert	사막, 버리다
deserve	받을가치가있다, ~할 만하다
design	계획, 설계, 디지인
destroy	파괴하다
detective	탐정, 형사
devil	악마
dialogue	대화
diary	일기
dictionary	사전
different	다른
difficult	어려운
dig	파다
diligent	부지런한
dinning room	식당
direction	방향, 지시
dirty	더러운
disappoint	실망시키다
discuss	토론하다
dish	접시, 요리
ditch	도랑
dive	다이빙하다, 잠수하다
doll	인형
dollar	달러
downtown	번화가
drag	끌다
draw	당기다, 그리다
dream	꿈
drop	떨어지다, 물방울
drown	물에 빠뜨리다
drugstore	약국
drum	북
dry	마른
dull	무딘, 우둔한
dumb	벙어리의
dye	염색, 물감
early	일찍
earnings	벌이
earth	지구, 땅
edge	가장자리
education	교육
effect	결과,영향,효과
effort	노력
either	어느 한쪽의, 또한
elder	손위의, 연상의
election	선거
electricity	전기
elementary	초보의, 초등학교의
else	그 밖에
empty	빈
enemy	적
energy	힘, 활기
engage	고용하다, 약속하다
engineer	기사, 공학자
enjoy	즐기다
enough	충분한
entire	전체의
envelope	봉투
equal	같은, 동등한
eraser	지우개
error	잘못
especially	특별히
event	사건
evil	악, 나쁜
exactly	정확히
examination	시험, 검사
example	예, 보기
excellent	뛰어난
except	제외하다
exchange	교환하다
excited	흥분한
excuse	용서하다, 변명
exercise	운동, 연습
exit	출구
expect	기대하다
expensive	값비싼
experience	경험
explain	설명하다
explode	폭발시키다
explore	탐험하다
expressway	고속도로
fact	사실
factory	공장
fail	실패하다
fair	공평한, 박람회
famous	유명한
fare	교통요금
fat	살찐, 지방
fault	결점, 잘못
favorite	아주 좋아하는
fear	두려워하다
feast	잔치, 향연
feather	깃털
feed	먹이다
fence	울타리
fever	열
fierce	사나운, 맹렬한
fight	싸우다
figure	인물, 모양, 숫자
fill	채우다
finally	마침내, 최후로
firm	굳은, 회사
flame	불꽃
flashlight	회중전등, 카메라의 플래시
flat	평평한
flight	비행
float	뜨다
flood	홍수
flow	흐르다
flute	플룻, 피리
fog	안개
folk	사람들
follow	따르다
foolish	어리석은
force	힘, 강요하다
foreign	외국의
forest	숲
fortunately	운좋게, 다행히
forward	앞으로
foundation	기초
fountain-pen	만년필
frankly	솔직히
french	프랑스사람, 프랑스어
fresh	새로운, 신선한
frighten	두렵게하다
frog	개구리
front	정면, 앞부분
fruit	과일
fun	재미
funeral	장례식
fur	모피
furniture	가구
further	더욱이, 그 이상의
future	미래
gain	얻다
gallery	화랑
garage	차고
gather	모으다
gay	명랑한, 화려한
gaze	응시하다
general	일반적인, 장군
German	독일사람, 독일어
gesture	몸짓
giant	거대한
gift	선물, 타고난 재능
giraffe	기린
glory	영광
goal	목표, 골
god	신
government	정부
grab	움켜잡다
grade	학년, 등급
graduate	졸업하다
grain	곡식, 낱알
grammar	문법
grand	웅장한, 광대한
grass	풀, 잔디
grave	무덤, 중대한
gray	회색
greedy	탐욕스러운
greeting	인사
ground	땅, 운동장
group	집단
guard	지키다, 경계
guess	추측하다
guest	손님
guide	안내자, 안내하다
gun	총
habit	습관, 버릇
halt	정지하다
hand	손, 건네주다
handle	손잡이, 다루다
handshake	악수
handsome	잘생긴, 멋진
hang	걸다, 매달다
happen	발생하다
hardly	거의~하지 않다
harmful	해로운
harvest	수확
haste	성급한, 서두름
hate	미워하다
hawk	매
hay	건초
health	건강
heart	심장
heat	열, 더위
heaven	하늘
heavy	무거운
hero	영웅, 주인공
hesitate	주저하다, 망설이다
hide	감추다, 숨다
history	역사
hit	치다
hobby	취미
hold	붙잡다, 개최하다
hole	구멍
holiday	휴일, 휴가
hollow	속이 빈, 움푹 꺼진
homesick	향수병의
hometown	고향
honest	정직한
honor	명예, 경의
hop	한 발로 깡총 뛰다
horizon	수평선
horn	뿔, 경적
hospital	병원
however	그러나, 아무리~해도
howl	짖다, 울부짖다
huge	거대한
hunger	굶주림
hunter	사냥군
hurray	만세
hurry	서두르다
hurt	상처를 입히다
husband	남편
hut	오두막집
hydrogen	수소
iceberg	빙산
idea	생각, 이념
imagine	상상하다
immediately	곧, 즉시
import	수입하다
important	중요한
include	포함하다
increase	증가하다
indeed	참으로
independent	독립의
industrial	산업의, 공업의
information	정보, 통지
inner	안쪽의
insect	곤충
instead	대신에
instrument	기구, 도구
interest	이익, 흥미, 이자
interesting	재미있는
international	국제적인
intimate	친밀한
introduce	소개하다, 도입하다
invader	침입자
invent	발명하다
invite	초대하다
ivy	담쟁이 덩굴
jar	항아리
jeans	청바지
jewel	보석
job	직업, 일
join	결합하다, 참가하다
joke	농담
journey	여행
joy	기쁨
judge	재판관, 판단하다
junior	후배, 손아래의
kind	친절한, 종류
kindergarten	유치원
knee	무릎
label	꼬리표, 상표
lamb	새끼양
language	언어
lantern	랜턴
later	나중에
laundry	세탁소, 세탁물
lay	~을 놓다, 눕히다
lead	이끌다, 인도하다
leak	새다
leap	뛰다
least	최소한의, 가장 적은
lend	빌려주다
lesson	학과, 교훈
letter	편지, 글자
liberty	자유
library	도서관
license	면허
life	생명, 생활
lift	들어올리다
limit	제한, 제한하다
list	명단
living room	거실
load	짐, 부담
loaf	빵 한 덩어리
locate	위치하다
lock	자물쇠, 자물쇠를 채우다
log	통나무
lonely	고독한
lose	잃다, 지다
loud	목소리가 큰, 시끄러운
low	낮은, 낮게
luck	행운
machine	기계
magazine	잡지
main	주요한
mammal	포유동물
mankind	인류
marble	대리석
march	행진, 행진하다
marry	결혼하다
mars	화성
master	주인, 정복하다
match	시합, ~에 필적하다
math	수학
matter	문제, 중요하다
maybe	아마
mayor	시장
meat	고기
memory	기억
mention	말하다
merchant	상인
merry	즐거운
metal	금속
method	방법
might	힘
mild	온화한
mile	마일
million	백만
mind	마음, 꺼리다
miss	놓치다, 그리워하다
mistake	잘못, 잘못알다
modern	현대의
moment	순간
monk 	승려
monument	기념비
mostly	대개는
mouse	생쥐
museum	박물관
musician	음악가
mystery	신비, 불가사리
nail	손톱, 못
nation	국가
nature	자연
navy	해군
nearly	거의
necessary	필요한
need	필요로 하다
neighbor	이웃
neither	어느쪽도 아니다
nephew	조카
nickname	별명, 애칭
niece	조카딸
noble	고귀한
nod	끄덕이다
noise	소음
none	아무도 ~않다
normal	보통의
nuclear	핵의
nurse	간호사
oath	맹세, 선서
obey	복종하다
object	사물,목적,반대하다
obtain	얻다
occur	발생하다
ocean	대양
offer	제공하다
office	사무실
officer	장교, 공무원
once	한번, 한때
operator	교환수, 조작자
opinion	의견
order	순서, 명령
ostrich	타조
otherwise	그렇지 않으면
overhear	엿듣다
owe	신세지다, 빚지다
owl	올빼미
own	자기자신의, 소유하다
pair	한 쌍
pal	친구
palace	궁전
parade	행렬
pardon	용서
pass	기나가다, 합격하다
passenger	승객
passport	여권
past	과거의, ~을 지나서
patient	환자, 참을성 있는
pause	중지, 멈추다
peaceful	평화로운
pepper	후추
perhaps	아마
pet	애완동물
petal	꽃잎
photographer	사진사
pick	고르다, 줍다
piece	한 조각
pigeon	비둘기
pilgrim	순례자
pill	알약
pilot	조종사
pitch	던지다
plane	비행기
planet	행성
plant	식물, 심다, 공장
plate	접시
pleasant	기분좋은, 유쾌한
plenty	풍부, 많은
poet	시인
politely	공손히, 예의바르게
pollution	오염
pop	평하고 소리나다, 대중음악
popular	인기있는
population	인구
port	항구
possible	가능한
post	우편, 우편물
potato	감자
powder	가루, 화약
practice	연습, 관습, 실행
prairie	대초원
pray	기도하다
precious	귀중한
prepare	준비하다
present	현재, 선물, 주다
president	대통령, 장
press	누르다
pretend	~인 체하다
pretty	예쁜, 상당히
price	값, 가격
primary	제1의, 주요한
prince	왕자
principal	중요한, 교장
prison	감옥
private	개인의
prize	상, 상품
probably	아마
problem	문제
produce	생산하다
project	계획, 투영하다
promise	약속, 전망
pronunciation	발음
properly	적당히, 올바르게
protect	보호하다
proud	자랑스러운
prove	증명하다
proverb	속담
public	공공의, 공중의
pull	잡아당기다, 끌다
pulse	맥박
pumpkin	호박
puritan	청교도
purpose	목적
push	밀다
puzzle	퍼즐, 당혹하게 하다
quarter	4분의 1, 15분
quiet	조용한
quite	꽤, 완전히
race	경주, 인종
raise	들어 올리다
rapidly	빨리, 신속히
rat	쥐, 들쥐
rate	비율, 평가하다
rather	오히려, 얼마간
reach	도달하다
rear	뒤쪽, 기르다
reason	이성, 이유
receive	받다
recently	최근의(= lately)
record	기록
refrigerator	냉장고
refuse	거절하다
regular	규칙적인, 보통의
rein	고삐
relative	친척, 관계가 있는
relay	교대자, 교대하다
religious	종교적인
remain	남다
remember	기억하다
remind	생각나게 하다
remove	제거하다, 옮기다
repeat	반복하다
replace	~을 대신하다, 제자리에 놓다
reply	대답, 대답하다
report	보고, 보고하다
republic	공화국
resources	자원
respect	존경하다
rest	휴식, 나머지
restaurant	식당
return	되돌아가다, 돌려주다
review	복습하다
revival	부활
revolution	혁명, 회전
rid	제거하다
riddle	수수께끼
ride	(탈 것에)타다
roar	으르렁거리다
robber	강도
roll	구르다, 두루마기
rope	밧줄
route	길
row	줄, 횡렬, 노젓다
rub	문지르다
rudely	무례하게
ruin	파멸
rule	규칙, 지배하다
sad	슬픈
safely	안전하게
sail	항해하다
sale	판매, 염가판매
salt	소금
sample	견본
sand	모래
save	구하다, 저축하다
saw	톱, 톱질하다
saying	격언
scar	상처
scare	겁주다, 위협하다
scene	장면, 현장
schedule	예정표
scholar	학자
science	과학
score	점수, 20
scratch	할퀴다, 긁다
scream	비명지르다
sculpture	조각품
search	찾다
seat	좌석, 앉히다
secretary	비서
section	부분, 구역
seed	씨, 씨 뿌리다
seldom	거의~하지 않다
select	고르다, 선택하다
semester	학기
senior	선배, 손위의
sentence	문장, 판결
series	연속, 시리즈
serious	진지한
servant	하인
settler	정착자
several	여럿의, 몇몇의
shade	그늘
shadow	그림자
shake	떨다, 흔들다
shape	모양
sharp	날카로운
sheep	양
sheet	침대의 시트, 종이 한 장
shell	조개
shine	빛나다
shock	충격, 충격을 주다
shoot	쏘다, 사격하다
shore	물가, 바닷가
short	짧은, 부족한
shoulder	어깨
shout	외치다
shower	소나기, 샤워
shrug	어깨를 으쓱하다
shut	닫다
sick	병든, 싫증난
sigh	한숨쉬다
sight	광경, 경치
sign	신호
silent	조용한, 침묵의
silk	비단
silly	어리석은
similar	비슷한
simple	간단한, 단순한
since	그 후, 때문에
sincerely	성실히
single	단 하나의, 독신의
sink	가라앉다
site	위치, 장소
situation	위치, 상황
skill	기술, 숙련
slave	노예
slide	미끄러지다
slip	미끄러짐
smart	똑똑한
smell	냄새, 냄새맡다
smoke	연기, 담배피다
snake	뱀
sniff	냄새맡다
social	사회의
solar	태양의
soldier	군인
solution	해결, 용해
sometime	언젠가
sophomore	2학년생
sore	아픈
sound	소리가 나다, 소리
source	출처, 근원
sow	씨를 뿌리다
space	공간, 우주
spade	삽
special	특별한
speech	말, 연설
spend	쓰다, 소비하다
spirit	정신, 영혼
spot	지점
square	정사각형, 광장
squirrel	다람쥐
stadium	경기장
stage	무대, 단계
stair	계단
stare	응시하다
state	상태, 국가, 말하다
statue	조각상
stay	머무르다
steady	꾸준한
steal	훔치다
stem	줄기, 유래하다
step	걸음, 단계, 조치
stethoscope	청진기
stomach	위, 배
stone	돌
store	가게, 저장하다
stormy	폭풍의
straight	똑바른
strange	이상한, 낯선
stream	흐름, 개울
stress	압박, 강조하다
stripe	줄무늬
struggle	노력, 분투하다
stupid	어리석은
subject	주어, 주제
suburb	교외
subway	지하도, 지하철
successful	성공한
such	그러한, 이러한
suck	빨다
suddenly	갑자기
suffer	고통을 겪다
sugar	설탕
suitcase	여행가방
sunrise	해돋이
sunshine	햇빛
superstition	미신
supply	공급, 공급하다
suppose	상상하다, 가정하다
surface	표면
surprise	놀라다
surround	둘러싸다
survive	살아남다
sweet	달콤한
swing	그네, 회전하다
sword	칼
symbol	상징
system	조직, 체계
tail	꼬리
taste	맛, 취향
tax	세금
tear	찢다, 눈물
teenager	10대
temperature	온도
temple	절, 사원
terrible	끔직한, 무서운
theater	극장
thermometer	온도계
thief	도둑
thin	얇은, 야윈
thirsty	목마른
though	비록~일지라도
throat	목구멍
throw	던지다
thumb	엄지손가락
ticket	표, 입장권
tie	매다, 묶다, 동점
tightly	단단히
tiny	몹시 작은
together	함께
tomb	무덤
tongue	혀, 언어
tool	도구
tooth	이
torch	햇불
touch	닿다, 감동시키다
tough	거친, 질긴
tourist	여행자
toward	~쪽으로
towel	수건, 타월
tower	탑
town	마을
track	지나간 자국, 선로
tradition	전통
traffic	교통
travel	여행자
treasure	보물
treat	다루다, 대접하다
trick	계략
trip	여행
triumph	승리
trouble	고생, 걱정하다
trousers	바지
trumpet	나팔
trust	신뢰
turkey	칠면조
turn	돌다, 변화하다
tuttle	바다거북
twice	두 번, 두배
twin	쌍둥이의 한 사람
type	유형
umbrella	우산
understand	이해하다
uniform	제복, 한 모양의
unity	통일, 일치
universe	우주, 전세계
unless	만약 ~하지 않는다면
unlike	같지 않은
upset	뒤업다, 당황케하다
upside down	거꾸로
useless	쓸모 없는
usually	보통, 대개
vacation	휴가
vain	헛된
valley	골짜기, 계곡
valuable	귀중한
various	여러가지의
vegetable	야채
view	경치, 의견
village	마을
voice	목소리
vote	투표하다, 투표
voyage	항해
wagon	짐마차
wake	깨우다
war	전쟁
warn	경고하다
waste	낭비하다
watch	손목시계, 지켜보다
weak	약한
wealth	재산, 부
wear	입다, 닳다
weather	날씨
wedding	결혼, 결혼식
weight	무게
wet	젖은
whether	~인지 아닌지
while	~하는 동안
whisker	구렛나루
whisper	속삭이다
whistle	휘파람을 불다
whole	전부
wide	넓은
wild	야생의, 난폭한
win	이기다, 얻다
wink	눈을 깜박거리다, 눈짓하다
wise	현명한
wish	소원, 원하다
without	~없이
wolf	늑대
wonderful	놀랄만한, 훌륭한
wood	나무, 숲
wool	양털
word	단어
worry	걱정하다
worth	가치, 가치가 있는
wound	상처, 부상
wrap	싸다
wrong	나쁜,틀린
yell	외치다